111111111111111
1P0000000000001
100N000N00N0001
100000000000001
110C000C000C011
10100C000C00101
1001000C0001001
10C0000E0000C01
1001000C0001001
10100C000C00101
110C000C000C011
100000000000001
100N000N000N001
100000000000001
100000000000001
111111111111111
