111111111111111
100C00000000C01
111101111101111
100N00000000001
111111101111111
10000000C000N01
1000000E0000001
10N000C00000001
111111101111111
100N00000N00001
100000C00000001
100011111111111
10C000C00000001
111111111110001
10C0000P0000001
111111111111111
