1111111111111111111111
1CP00000000001110000E1
10000000000001C0000NN1
1001010000000111N0NNN1
1001C10000000000000NN1
1111111111111111111111
