1111111111111111111111111111111111
1E00000000000000000000000000000001
1000000000000000000000000000001001
1000000000000000000000000000001001
1P0000000C000000110000000C1C1C1001
1000000000C0NN00N0001010111101C001
10011111000C00000N0010101111000001
100001110000NNNN000010101111000001
1000000000000000000000000000000001
100000000000000000N000000000000001
1000000000000000000000000000000001
1111111111111111111111111111111111
