111111
1P00E1
111001
1C0001
111111
