111111111111111
100C00000000C01
111101111101111
100000000000001
111111101111111
10000000C000001
1000000E0000001
100000C00000001
111111101111111
100000000000001
100000C00000001
100011111111111
10C000C00000001
111111111110001
10C0000P0000001
111111111111111
