1111111111111111111111111111111111
1E0000000000000C00000C000000000001
1010010100100000101001000000010101
1110010010101010001001000000010101
1P0000000C00C0001100000000000000C1
1000000000C00000000010101111000001
10000000000C0000000010101111000001
1000000000000000000010101111000001
1000000000CC0000000010101111000001
1111111111111111111111111111111111
